0000x0000x0000
0000x0000x0000
00000000000000
0000x0000x0000
xx0xxx00xxx0xx
0000x0000x0000
000000g0000000
00000000000000
0000x0000x0000
xx0xxx00xxx0xx
0000x0000x0000
0i000000000000
0000x0000x0000
0000x0000x0000